11111111111111111111111111111111
1000000P0C0000000000000000000001
10000000000000000000000000000001
1111111111000000C000111111000001
10000000000000000000100000C00001
10C00000000000C00000100000000001
1000C00000000000100010000C000001
10000001111111111111110000000001
111111110000000000C0010000000001
1C000000001110000000111111100001
10011111111000001111100000000001
1000000C000001000000100100000001
111111111110010000000001000C0001
1E0000000000010C0000000100000001
11111111111111111111111111111111